{
name: ""
width: 10
height: 5
plan.types: [
	"L L L L L L L L L L "
	"L L L L L L L L L L "
	"L L L L L L L L L L "
	"L L L L L L L L L L "
	"L L L L L L L L L L "
]
plan.letters: [
	"- - - - - - - - - - "
	"- - - - - - - - - - "
	"- - - - - - - - - - "
	"- - - - - - - - - - "
	"- - - - - - - - - - "
]
plan.powers: [
	"1 1 1 1 1 1 1 1 1 1 "
	"1 1 1 1 1 1 1 1 1 1 "
	"1 1 1 1 1 1 1 1 1 1 "
	"1 1 1 1 1 1 1 1 1 1 "
	"1 1 1 1 1 1 1 1 1 1 "
]
plan.owners: [
	"0 0 0 0 0 0 0 0 0 0 "
	"0 0 0 0 0 0 0 0 0 0 "
	"0 0 0 0 0 0 0 0 0 0 "
	"0 0 0 0 0 0 0 0 0 0 "
	"0 0 0 0 0 0 0 0 0 0 "
]
plan.zone: [
	"- - - - - - - - - - "
	"- - - - - - - - - - "
	"- - - - - - - - - - "
	"- - - - - - - - - - "
	"- - - - - - - - - - "
]
}