{
name: 0_first_assault
skin: default
width: 7
height: 7
types: [
	"L L L L L L L "
	"L L L L L L L "
	"L L L L L L L "
	"L L L L L L L "
	"L L L L L L L "
	"L L L L L L L "
	"L L L L L L L "
]
letters: [
	"- - - - - - - "
	"- - - - - - - "
	"- - - - - - - "
	"- - - - - - - "
	"- - - - - - - "
	"- - - - - - - "
	"- - - - - - - "
]
powers: [
	"1 1 1 1 1 1 1 "
	"1 1 1 1 1 1 1 "
	"1 1 1 1 1 1 1 "
	"1 1 1 1 1 1 1 "
	"1 1 1 1 1 1 1 "
	"1 1 1 1 1 1 1 "
	"1 1 1 1 1 1 1 "
]
owners: [
	"0 0 0 0 0 0 1 "
	"0 0 0 0 0 0 0 "
	"0 0 0 0 0 0 0 "
	"0 0 0 0 0 0 0 "
	"0 0 0 0 0 0 0 "
	"0 0 0 0 0 0 0 "
	"2 0 0 0 0 0 0 "
]
zones: [
	"3 3 - - - 1 1 "
	"3 3 5 5 5 1 1 "
	"- 5 5 5 5 5 - "
	"- 5 5 5 5 5 - "
	"- 5 5 5 5 5 - "
	"2 2 5 5 5 4 4 "
	"2 2 - - - 4 4 "
]
walls: []
}