{
name: 1_ivory_tower
width: 9
height: 9
plan.types: [
	"L L L L L L L L L "
	"L L L L L L L L L "
	"L L L L L L L L L "
	"L L L L L L L L L "
	"L L L L J L L L L "
	"L L L L L L L L L "
	"L L L L L L L L L "
	"L L L L L L L L L "
	"L L L L L L L L L "
]
plan.letters: [
	"- - - - - - - - - "
	"- - - - - - - - - "
	"- - - - - - - - - "
	"- - - - - - - - - "
	"- - - - - - - - - "
	"- - - - - - - - - "
	"- - - - - - - - - "
	"- - - - - - - - - "
	"- - - - - - - - - "
]
plan.powers: [
	"1 1 1 1 1 1 1 1 1 "
	"1 1 1 1 1 1 1 1 1 "
	"1 1 1 1 1 1 1 1 1 "
	"1 1 1 1 1 1 1 1 1 "
	"1 1 1 1 0 1 1 1 1 "
	"1 1 1 1 1 1 1 1 1 "
	"1 1 1 1 1 1 1 1 1 "
	"1 1 1 1 1 1 1 1 1 "
	"1 1 1 1 1 1 1 1 1 "
]
plan.owners: [
	"0 0 0 0 0 0 0 0 1 "
	"0 0 0 0 0 0 0 0 0 "
	"0 0 0 0 0 0 0 0 0 "
	"0 0 0 0 0 0 0 0 0 "
	"0 0 0 0 0 0 0 0 0 "
	"0 0 0 0 0 0 0 0 0 "
	"0 0 0 0 0 0 0 0 0 "
	"0 0 0 0 0 0 0 0 0 "
	"2 0 0 0 0 0 0 0 0 "
]
plan.zones: [
	"1 1 1 1 - 2 2 2 2 "
	"1 1 1 1 - 2 2 2 2 "
	"1 1 - - - - - 2 2 "
	"1 1 - 5 5 5 - 2 2 "
	"- - - 5 5 5 - - - "
	"4 4 - 5 5 5 - 3 3 "
	"4 4 - - - - - 3 3 "
	"4 4 4 4 - 3 3 3 3 "
	"4 4 4 4 - 3 3 3 3 "
]
plan.walls: [
	6;6 7;6
	6;6 6;7
	2;2 1;2
	2;2 2;1
	3;2 3;1
	2;3 1;3
	7;5 6;5
	5;7 5;6
	7;3 6;3
	1;5 2;5
	5;1 5;2
	3;7 3;6
	2;6 2;7
	2;6 1;6
	6;2 7;2
	6;2 6;1
]
}