{
name: 3_diamond
skin: default
width: 10
height: 12
types: [
	"L L L V V V V L L L "
	"L L L V V V V L L L "
	"L L L L L L L L L L "
	"V V L L L L L L V V "
	"V V L L L L L L V V "
	"V L L L L L L L L V "
	"V L L L L L L L L V "
	"V V L L L L L L V V "
	"V V L L L L L L V V "
	"L L L L L L L L L L "
	"L L L V V V V L L L "
	"L L L V V V V L L L "
]
letters: [
	"- - - - - - - - - - "
	"- - - - - - - - - - "
	"- - - - - - - - - - "
	"- - - - - - - - - - "
	"- - - - - - - - - - "
	"- - - - - - - - - - "
	"- - - - - - - - - - "
	"- - - - - - - - - - "
	"- - - - - - - - - - "
	"- - - - - - - - - - "
	"- - - - - - - - - - "
	"- - - - - - - - - - "
]
powers: [
	"1 1 1 0 0 0 0 1 1 1 "
	"1 1 1 0 0 0 0 1 1 1 "
	"1 1 1 1 1 1 1 1 1 1 "
	"0 0 1 1 1 1 1 1 0 0 "
	"0 0 1 1 1 1 1 1 0 0 "
	"0 1 1 1 1 1 1 1 1 0 "
	"0 1 1 1 1 1 1 1 1 0 "
	"0 0 1 1 1 1 1 1 0 0 "
	"0 0 1 1 1 1 1 1 0 0 "
	"1 1 1 1 1 1 1 1 1 1 "
	"1 1 1 0 0 0 0 1 1 1 "
	"1 1 1 0 0 0 0 1 1 1 "
]
owners: [
	"0 0 0 0 0 0 0 0 0 0 "
	"0 1 0 0 0 0 0 0 2 0 "
	"0 0 0 0 0 0 0 0 0 0 "
	"0 0 0 0 0 0 0 0 0 0 "
	"0 0 0 0 0 0 0 0 0 0 "
	"0 0 0 0 0 0 0 0 0 0 "
	"0 0 0 0 0 0 0 0 0 0 "
	"0 0 0 0 0 0 0 0 0 0 "
	"0 0 0 0 0 0 0 0 0 0 "
	"0 0 0 0 0 0 0 0 0 0 "
	"0 2 0 0 0 0 0 0 1 0 "
	"0 0 0 0 0 0 0 0 0 0 "
]
zones: [
	"1 1 1 - - - - 3 3 3 "
	"1 1 1 - - - - 3 3 3 "
	"1 1 1 - 5 5 - 3 3 3 "
	"- - - 5 5 5 5 - - - "
	"- - 8 - - - - 6 - - "
	"- 8 8 - 9 9 - 6 6 - "
	"- 8 8 - 9 9 - 6 6 - "
	"- - 8 - - - - 6 - - "
	"- - - 7 7 7 7 - - - "
	"4 4 4 - 7 7 - 2 2 2 "
	"4 4 4 - - - - 2 2 2 "
	"4 4 4 - - - - 2 2 2 "
]
walls: []
}