{
name: 5_glass_nightmare
skin: default
width: 10
height: 12
types: [
	"L L L L L L L L L L "
	"L L L L L L L L L L "
	"L L L L L L L L L L "
	"G G G G G G G G G G "
	"L L L G L L G L L L "
	"L L L G L L G L L L "
	"L L L G L L G L L L "
	"L L L G L L G L L L "
	"G G G G G G G G G G "
	"L L L L L L L L L L "
	"L L L L L L L L L L "
	"L L L L L L L L L L "
]
letters: [
	"- - - - - - - - - - "
	"- - - - - - - - - - "
	"- - - - - - - - - - "
	"- - - - - - - - - - "
	"- - - - - - - - - - "
	"- - - - - - - - - - "
	"- - - - - - - - - - "
	"- - - - - - - - - - "
	"- - - - - - - - - - "
	"- - - - - - - - - - "
	"- - - - - - - - - - "
	"- - - - - - - - - - "
]
powers: [
	"1 1 1 1 1 1 1 1 1 1 "
	"1 1 1 1 1 1 1 1 1 1 "
	"1 1 1 1 1 1 1 1 1 1 "
	"1 1 1 1 1 1 1 1 1 1 "
	"1 1 1 1 1 1 1 1 1 1 "
	"1 1 1 1 1 1 1 1 1 1 "
	"1 1 1 1 1 1 1 1 1 1 "
	"1 1 1 1 1 1 1 1 1 1 "
	"1 1 1 1 1 1 1 1 1 1 "
	"1 1 1 1 1 1 1 1 1 1 "
	"1 1 1 1 1 1 1 1 1 1 "
	"1 1 1 1 1 1 1 1 1 1 "
]
owners: [
	"0 0 0 0 1 1 0 0 0 0 "
	"0 0 0 0 0 0 0 0 0 0 "
	"0 0 0 0 0 0 0 0 0 0 "
	"0 0 0 0 0 0 0 0 0 0 "
	"0 0 0 0 0 0 0 0 0 0 "
	"0 0 0 0 0 0 0 0 0 0 "
	"0 0 0 0 0 0 0 0 0 0 "
	"0 0 0 0 0 0 0 0 0 0 "
	"0 0 0 0 0 0 0 0 0 0 "
	"0 0 0 0 0 0 0 0 0 0 "
	"0 0 0 0 0 0 0 0 0 0 "
	"0 0 0 0 2 2 0 0 0 0 "
]
zones: [
	"- - 1 1 1 1 1 1 - - "
	"- - 1 1 1 1 1 1 - - "
	"- - - - - - - - - - "
	"- - - - - - - - - - "
	"3 3 3 - 5 5 - 4 4 4 "
	"3 3 3 - 5 5 - 4 4 4 "
	"3 3 3 - 5 5 - 4 4 4 "
	"3 3 3 - 5 5 - 4 4 4 "
	"- - - - - - - - - - "
	"- - - - - - - - - - "
	"- - 2 2 2 2 2 2 - - "
	"- - 2 2 2 2 2 2 - - "
]
walls: []
}