{
name: 6_bomb_squad
skin: default
width: 10
height: 7
types: [
	"L L L B L L B L L L "
	"L B L L L L L L B L "
	"L L L L L L L L L L "
	"B L B L B B L B L B "
	"L L L L L L L L L L "
	"L B L L L L L L B L "
	"L L L B L L B L L L "
]
letters: [
	"- - - - - - - - - - "
	"- - - - - - - - - - "
	"- - - - - - - - - - "
	"- - - - - - - - - - "
	"- - - - - - - - - - "
	"- - - - - - - - - - "
	"- - - - - - - - - - "
]
powers: [
	"1 1 1 1 1 1 1 1 1 1 "
	"1 1 1 1 1 1 1 1 1 1 "
	"1 1 1 1 1 1 1 1 1 1 "
	"1 2 1 2 1 1 2 1 2 1 "
	"1 1 1 1 1 1 1 1 1 1 "
	"1 1 1 1 1 1 1 1 1 1 "
	"1 1 1 1 1 1 1 1 1 1 "
]
owners: [
	"0 0 0 0 0 0 0 0 1 1 "
	"0 0 0 0 0 0 0 0 0 0 "
	"0 0 0 0 0 0 0 0 0 0 "
	"0 0 0 0 0 0 0 0 0 0 "
	"0 0 0 0 0 0 0 0 0 0 "
	"0 0 0 0 0 0 0 0 0 0 "
	"2 2 0 0 0 0 0 0 0 0 "
]
zones: [
	"4 4 4 - - - - 2 2 2 "
	"4 4 4 - 3 3 - 2 2 2 "
	"- - - - 3 3 - - - - "
	"7 7 7 3 3 3 3 6 6 6 "
	"- - - - 3 3 - - - - "
	"1 1 1 - 3 3 - 5 5 5 "
	"1 1 1 - - - - 5 5 5 "
]
walls: []
}