{
name: DBG
skin: default
width: 7
height: 7
types: [
	"L L L L L L L "
	"L L L L L L L "
	"L L L L L L L "
	"L L L L L L L "
	"L L L L L L L "
	"L L L L L L L "
	"L L L L L L L "
]
letters: [
	"- - - - - - - "
	"- - - - - - - "
	"- - - - - - - "
	"- - - - - - - "
	"- - - - - - - "
	"- - - - - - - "
	"- - - - - - - "
]
powers: [
	"1 1 1 1 1 1 1 "
	"1 1 1 1 1 1 1 "
	"1 1 1 1 1 1 1 "
	"1 1 1 1 1 1 1 "
	"1 1 1 1 1 1 1 "
	"1 1 1 1 1 1 1 "
	"1 1 1 1 1 1 1 "
]
owners: [
	"0 0 0 0 0 0 1 "
	"0 0 0 0 0 0 0 "
	"0 0 0 0 0 0 0 "
	"0 0 1 0 0 0 0 "
	"0 0 1 1 0 0 0 "
	"0 0 0 0 1 0 0 "
	"2 0 0 0 0 0 0 "
]
zones: [
	"- - - - - - - "
	"- - - - - - - "
	"- - 1 1 1 - - "
	"- - 1 1 1 - - "
	"- - 1 1 1 - - "
	"- - - - - - - "
	"- - - - - - - "
]
walls: []
}