{
name: editor
skin: default
width: 7
height: 7
types: [
	"L L L L L L L "
	"L L L L L L L "
	"L L L L L L L "
	"L L L L L L L "
	"L L L L L L L "
	"L L L L L L L "
	"L L L L L L L "
]
letters: [
	"- - - - - - - "
	"- - - - - - - "
	"- - - - - - - "
	"- - - - - - - "
	"- - - - - - - "
	"- - - - - - - "
	"- - - - - - - "
]
powers: [
	"1 1 1 1 1 1 1 "
	"1 1 1 1 1 1 1 "
	"1 1 1 1 1 1 1 "
	"1 1 1 1 1 1 1 "
	"1 1 1 1 1 1 1 "
	"1 1 1 1 1 1 1 "
	"1 1 1 1 1 1 1 "
]
owners: [
	"2 2 2 2 2 2 2 "
	"2 2 2 2 2 2 2 "
	"2 2 2 1 2 2 2 "
	"2 2 2 2 2 2 2 "
	"2 2 2 2 2 2 2 "
	"2 2 2 2 2 2 2 "
	"2 2 2 2 2 2 2 "
]
zones: [
	"1 1 1 - - - - "
	"1 1 1 - - - - "
	"1 1 1 - - - - "
	"- - - - - - - "
	"- - - - - - - "
	"- - - - - - - "
	"- - - - - - - "
]
walls: []
}