{
name: editor
skin: default
width: 7
height: 7
types: [
	"L L L L L L L "
	"L L L L L L L "
	"L L L L L L L "
	"L L L L L L L "
	"L L L L L L L "
	"L L L L L L L "
	"L L L L L L L "
]
letters: [
	"- - - - - - - "
	"- - - - - - - "
	"- - - - - - - "
	"- - - - - - - "
	"- - - - - - - "
	"- - - - - - - "
	"- - - - - - - "
]
powers: [
	"1 1 1 1 1 1 1 "
	"1 1 1 1 1 1 1 "
	"1 1 1 1 1 1 1 "
	"1 1 1 1 1 1 1 "
	"1 1 1 1 1 1 1 "
	"1 1 1 1 1 1 1 "
	"1 1 1 1 1 1 1 "
]
owners: [
	"0 0 0 0 0 0 0 "
	"0 0 0 0 0 0 0 "
	"0 0 0 0 0 0 0 "
	"0 0 0 0 0 0 0 "
	"0 0 0 0 0 0 0 "
	"0 0 0 0 0 0 0 "
	"0 0 0 0 0 0 0 "
]
zones: [
	"- - - - - - - "
	"- - - - - - - "
	"- - - - - - - "
	"- - - - - - - "
	"- - - - - - - "
	"- - - - - - - "
	"- - - - - - - "
]
walls: []
}