{
name: 2_trench_warfare
width: 7
height: 12
plan.types: [
	"L L L L L L L "
	"L L L L L L L "
	"L L L L L L L "
	"L L L L L L L "
	"L L L L L L L "
	"L L L L L L L "
	"L L L L L L L "
	"L L L L L L L "
	"L L L L L L L "
	"L L L L L L L "
	"L L L L L L L "
	"L L L L L L L "
]
plan.letters: [
	"- - - - - - - "
	"- - - - - - - "
	"- - - - - - - "
	"- - - - - - - "
	"- - - - - - - "
	"- - - - - - - "
	"- - - - - - - "
	"- - - - - - - "
	"- - - - - - - "
	"- - - - - - - "
	"- - - - - - - "
	"- - - - - - - "
]
plan.powers: [
	"1 1 1 1 1 1 1 "
	"1 1 1 1 1 1 1 "
	"1 1 1 1 1 1 1 "
	"1 1 1 1 1 1 1 "
	"1 1 1 1 1 1 1 "
	"1 1 1 1 1 1 1 "
	"1 1 1 1 1 1 1 "
	"1 1 1 1 1 1 1 "
	"1 1 1 1 1 1 1 "
	"1 1 1 1 1 1 1 "
	"1 1 1 1 1 1 1 "
	"1 1 1 1 1 1 1 "
]
plan.owners: [
	"0 0 0 1 0 0 0 "
	"0 0 0 0 0 0 0 "
	"0 0 0 0 0 0 0 "
	"0 0 0 0 0 0 0 "
	"0 0 0 0 0 0 0 "
	"0 0 0 0 0 0 0 "
	"0 0 0 0 0 0 0 "
	"0 0 0 0 0 0 0 "
	"0 0 0 0 0 0 0 "
	"0 0 0 0 0 0 0 "
	"0 0 0 0 0 0 0 "
	"0 0 0 2 0 0 0 "
]
plan.zones: [
	"1 1 1 1 1 1 1 "
	"2 2 2 2 2 2 2 "
	"2 2 2 2 2 2 2 "
	"3 3 3 3 3 3 3 "
	"3 3 7 7 7 3 3 "
	"3 3 7 7 7 3 3 "
	"4 4 7 7 7 4 4 "
	"4 4 7 7 7 4 4 "
	"4 4 4 4 4 4 4 "
	"5 5 5 5 5 5 5 "
	"5 5 5 5 5 5 5 "
	"6 6 6 6 6 6 6 "
]
plan.walls: []
}