{
name: 4_battlefield
width: 10
height: 12
plan.types: [
	"L L L L L L L L L L "
	"L L L L L L L L L L "
	"L L L L L L L L L L "
	"L L L L L L L L L L "
	"L L L L L L L L L L "
	"L L L L L L L L L L "
	"L L L L L L L L L L "
	"L L L L L L L L L L "
	"L L L L L L L L L L "
	"L L L L L L L L L L "
	"L L L L L L L L L L "
	"L L L L L L L L L L "
]
plan.letters: [
	"- - - - - - - - - - "
	"- - - - - - - - - - "
	"- - - - - - - - - - "
	"- - - - - - - - - - "
	"- - - - - - - - - - "
	"- - - - - - - - - - "
	"- - - - - - - - - - "
	"- - - - - - - - - - "
	"- - - - - - - - - - "
	"- - - - - - - - - - "
	"- - - - - - - - - - "
	"- - - - - - - - - - "
]
plan.powers: [
	"1 1 1 1 1 1 1 1 1 1 "
	"1 1 1 1 1 1 1 1 1 1 "
	"1 1 1 1 1 1 1 1 1 1 "
	"1 1 1 1 1 1 1 1 1 1 "
	"1 1 1 1 1 1 1 1 1 1 "
	"1 1 1 1 2 2 1 1 1 1 "
	"1 1 1 1 2 2 1 1 1 1 "
	"1 1 1 1 1 1 1 1 1 1 "
	"1 1 1 1 1 1 1 1 1 1 "
	"1 1 1 1 1 1 1 1 1 1 "
	"1 1 1 1 1 1 1 1 1 1 "
	"1 1 1 1 1 1 1 1 1 1 "
]
plan.owners: [
	"0 0 0 0 1 1 0 0 0 0 "
	"0 0 0 0 0 0 0 0 0 0 "
	"0 0 0 0 0 0 0 0 0 0 "
	"0 0 0 0 0 0 0 0 0 0 "
	"0 0 0 0 0 0 0 0 0 0 "
	"0 0 0 0 0 0 0 0 0 0 "
	"0 0 0 0 0 0 0 0 0 0 "
	"0 0 0 0 0 0 0 0 0 0 "
	"0 0 0 0 0 0 0 0 0 0 "
	"0 0 0 0 0 0 0 0 0 0 "
	"0 0 0 0 0 0 0 0 0 0 "
	"0 0 0 0 2 2 0 0 0 0 "
]
plan.zones: [
	"- - 1 1 1 1 1 1 - - "
	"3 3 - - 1 1 - - 5 5 "
	"3 3 - - - - - - 5 5 "
	"3 3 - - - - - - 5 5 "
	"3 - - 7 - - 7 - - 5 "
	"3 - - 7 7 7 7 - - 5 "
	"4 - - 7 7 7 7 - - 6 "
	"4 - - 7 - - 7 - - 6 "
	"4 4 - - - - - - 6 6 "
	"4 4 - - - - - - 6 6 "
	"4 4 - - 2 2 - - 6 6 "
	"- - 2 2 2 2 2 2 - - "
]
}