{
name: 5_glass_nightmare
width: 12
height: 12
plan.types: [
	"L L L L L L L L L L L L "
	"L L L L L L L L L L L L "
	"L L L L L L L L L L L L "
	"G G G G G G G G G G L L "
	"L L L G L L G L L L L L "
	"L L L G L L G L L L L L "
	"L L L G L L G L L L L L "
	"L L L G L L G L L L L L "
	"G G G G G G G G G G L L "
	"L L L L L L L L L L L L "
	"L L L L L L L L L L L L "
	"L L L L L L L L L L L L "
]
plan.letters: [
	"- - - - - - - - - - - - "
	"- - - - - - - - - - - - "
	"- - - - - - - - - - - - "
	"- - - - - - - - - - - - "
	"- - - - - - - - - - - - "
	"- - - - - - - - - - - - "
	"- - - - - - - - - - - - "
	"- - - - - - - - - - - - "
	"- - - - - - - - - - - - "
	"- - - - - - - - - - - - "
	"- - - - - - - - - - - - "
	"- - - - - - - - - - - - "
]
plan.powers: [
	"1 1 1 1 1 1 1 1 1 1 1 1 "
	"1 1 1 1 1 1 1 1 1 1 1 1 "
	"1 1 1 1 1 1 1 1 1 1 1 1 "
	"1 1 1 1 1 1 1 1 1 1 1 1 "
	"1 1 1 1 1 1 1 1 1 1 1 1 "
	"1 1 1 1 1 1 1 1 1 1 1 1 "
	"1 1 1 1 1 1 1 1 1 1 1 1 "
	"1 1 1 1 1 1 1 1 1 1 1 1 "
	"1 1 1 1 1 1 1 1 1 1 1 1 "
	"1 1 1 1 1 1 1 1 1 1 1 1 "
	"1 1 1 1 1 1 1 1 1 1 1 1 "
	"1 1 1 1 1 1 1 1 1 1 1 1 "
]
plan.owners: [
	"0 0 0 0 1 1 0 0 0 0 0 0 "
	"0 0 0 0 0 0 0 0 0 0 0 0 "
	"0 0 0 0 0 0 0 0 0 0 0 0 "
	"0 0 0 0 0 0 0 0 0 0 0 0 "
	"0 0 0 0 0 0 0 0 0 0 0 0 "
	"0 0 0 0 0 0 0 0 0 0 0 0 "
	"0 0 0 0 0 0 0 0 0 0 0 0 "
	"0 0 0 0 0 0 0 0 0 0 0 0 "
	"0 0 0 0 0 0 0 0 0 0 0 0 "
	"0 0 0 0 0 0 0 0 0 0 0 0 "
	"0 0 0 0 0 0 0 0 0 0 0 0 "
	"0 0 0 0 2 2 0 0 0 0 0 0 "
]
plan.zones: [
	"- - 1 1 1 1 1 1 - - - - "
	"- - 1 1 1 1 1 1 - - - - "
	"- - - - - - - - - - - - "
	"- - - - - - - - - - - - "
	"3 3 3 - 5 5 - 4 4 4 - - "
	"3 3 3 - 5 5 - 4 4 4 - - "
	"3 3 3 - 5 5 - 4 4 4 - - "
	"3 3 3 - 5 5 - 4 4 4 - - "
	"- - - - - - - - - - - - "
	"- - - - - - - - - - - - "
	"- - 2 2 2 2 2 2 - - - - "
	"- - 2 2 2 2 2 2 - - - - "
]
plan.walls: []
}